֍֍֍֍֍֍֍֍֍֍֍֍֍֍֍֍֍֍֍֍֍֍֍֍֍֍֍֍֍֍֍֍֍֍֍֍֍֍֍֍֍֍֍֍֍֍֍֍֍֍֍֍֍֍֍֍֍֍֍֍֍֍֍֍֍֍֍֍֍֍֍֍֍֍֍֍֍֍֍֍֍֍֍֍֍֍֍֍֍֍֍֍֍֍֍֍֍֍֍֍
֍                                           ֍          ֍                                           ֍
֍                                           ֍          ֍                                           ֍
֍         ֍֍֍֍֍֍֍֍         ֍֍֍֍֍֍֍֍                              ֍֍֍֍֍֍֍֍         ֍֍֍֍֍֍֍֍         ֍
֍         ֍      ֍         ֍      ֍                              ֍      ֍         ֍      ֍         ֍
֍         ֍      ֍         ֍      ֍         ֍          ֍         ֍      ֍         ֍      ֍         ֍
֍         ֍֍֍֍֍֍֍֍         ֍֍֍֍֍֍֍֍         ֍          ֍         ֍֍֍֍֍֍֍֍         ֍֍֍֍֍֍֍֍         ֍
֍                                                                                                  ֍
֍                                                                                                  ֍
֍                                                                                                  ֍
֍                     ֍                                                      ֍                     ֍
֍                     ֍                                                       ֍                    ֍
֍      ֍              ֍              ֍            ֍            ֍               ֍            ֍      ֍
֍       ֍             ֍             ֍           ֍   ֍           ֍               ֍          ֍       ֍
֍        ֍            ֍            ֍           ֍     ֍           ֍              ֍         ֍        ֍
֍         ֍           ֍           ֍             ֍   ֍             ֍             ֍        ֍         ֍
֍                     ֍                           ֍                            ֍                   ֍
֍                     ֍                                                       ֍                    ֍
֍                     ֍                                                      ֍                     ֍
֍                                                                                                  ֍
֍                                                                                                  ֍
֍         ֍                       ֍                              ֍                       ֍         ֍
֍          ֍                     ֍                ֍               ֍                     ֍          ֍
֍           ֍ ֍ ֍ ֍ ֍ ֍ ֍ ֍ ֍ ֍ ֍                ֍ ֍               ֍ ֍ ֍ ֍ ֍ ֍ ֍ ֍ ֍ ֍ ֍           ֍
֍            ֍                 ֍                ֍   ֍               ֍                 ֍            ֍
֍             ֍               ֍                ֍     ֍               ֍               ֍             ֍
֍              ֍ ֍ ֍ ֍ ֍ ֍ ֍ ֍                ֍       ֍               ֍ ֍ ֍ ֍ ֍ ֍ ֍ ֍              ֍
֍                                            ֍         ֍                                           ֍
֍                                           ֍           ֍                                          ֍
֍֍֍֍֍֍֍֍֍֍֍֍֍֍֍֍֍֍֍֍֍֍֍֍֍֍֍֍֍֍֍֍֍֍֍֍֍֍֍֍֍֍֍֍֍֍֍֍֍֍֍֍֍֍֍֍֍֍֍֍֍֍֍֍֍֍֍֍֍֍֍֍֍֍֍֍֍֍֍֍֍֍֍֍֍֍֍֍֍֍֍֍֍֍֍֍֍֍֍֍