֍֍֍֍֍֍֍֍֍֍֍֍֍֍֍֍֍֍֍֍֍֍֍֍֍֍֍֍֍֍֍֍֍֍֍֍֍֍֍֍֍֍֍֍֍֍֍֍֍֍֍֍֍֍֍֍֍֍֍֍֍֍֍֍֍֍֍֍֍֍֍֍֍֍֍֍֍֍֍֍֍֍֍֍֍֍֍֍֍֍֍֍֍֍֍֍֍֍֍֍
֍                                      +    ֍          ֍                                           ֍
֍     +                                     ֍          ֍                                      +    ֍
֍         ֍֍֍֍֍֍֍֍         ֍֍֍֍֍֍֍֍         ֍          ֍         ֍֍֍֍֍֍֍֍         ֍֍֍֍֍֍֍֍         ֍
֍         ֍      ֍         ֍      ֍         ֍          ֍     +   ֍      ֍         ֍      ֍         ֍
֍         ֍      ֍         ֍      ֍         ֍          ֍         ֍      ֍         ֍      ֍         ֍
֍  +      ֍֍֍֍֍֍֍֍         ֍֍֍֍֍֍֍֍                              ֍֍֍֍֍֍֍֍         ֍֍֍֍֍֍֍֍         ֍
֍                                                                                                  ֍
֍                                                   +                                   +          ֍
֍                           +                                                                      ֍
֍                     ֍                                                      ֍                     ֍
֍                     ֍                     +                                 ֍                    ֍
֍      ֍              ֍              ֍            ֍            ֍               ֍            ֍      ֍
֍       ֍       +     ֍             ֍           ֍   ֍           ֍      +        ֍          ֍       ֍
֍        ֍            ֍            ֍           ֍     ֍           ֍              ֍         ֍        ֍
֍         ֍           ֍           ֍             ֍   ֍             ֍             ֍        ֍         ֍
֍                     ֍                           ֍                            ֍                   ֍
֍                     ֍                                                       ֍                    ֍
֍                     ֍                                    +                 ֍         +           ֍
֍                                        +                                                         ֍
֍                                                                                                  ֍
֍         ֍                       ֍                              ֍                       ֍         ֍
֍          ֍                     ֍                ֍               ֍                     ֍          ֍
֍           ֍֍֍֍֍֍֍֍֍֍֍֍֍֍֍֍֍֍֍֍֍                ֍ ֍               ֍֍֍֍֍֍֍֍֍֍֍֍֍֍֍֍֍֍֍֍֍           ֍
֍            ֍                                  ֍   ֍                                 ֍            ֍
֍             ֍ +             ֍                ֍     ֍               ֍             + ֍             ֍
֍              ֍֍֍֍֍֍֍֍֍֍֍֍֍֍֍                ֍       ֍               ֍֍֍֍֍֍֍֍֍֍֍֍֍֍֍              ֍
֍    +                                       ֍         ֍                                           ֍
֍                                           ֍           ֍     +                                    ֍
֍֍֍֍֍֍֍֍֍֍֍֍֍֍֍֍֍֍֍֍֍֍֍֍֍֍֍֍֍֍֍֍֍֍֍֍֍֍֍֍֍֍֍֍֍֍֍֍֍֍֍֍֍֍֍֍֍֍֍֍֍֍֍֍֍֍֍֍֍֍֍֍֍֍֍֍֍֍֍֍֍֍֍֍֍֍֍֍֍֍֍֍֍֍֍֍֍֍֍֍