֍֍֍֍֍֍֍֍֍֍֍֍֍֍֍֍֍֍֍֍֍֍֍֍֍֍֍֍֍֍֍֍֍֍֍֍֍֍֍֍֍֍֍֍֍֍֍֍֍֍֍֍֍֍֍֍֍֍֍֍֍֍֍֍֍֍֍֍֍֍֍֍֍֍֍֍֍֍֍֍֍֍֍֍֍֍֍֍֍֍֍֍֍֍֍֍֍֍֍֍
֍                                           ֍          ֍                                           ֍
֍                  +                        ֍          ֍                       +                   ֍
֍         ֍֍֍֍֍֍֍֍         ֍֍֍֍֍֍֍֍   +     ֍          ֍         ֍֍֍֍֍֍֍֍    +    ֍֍֍֍֍֍֍֍         ֍
֍         ֍      ֍     +   ֍      ֍         ֍          ֍     +   ֍      ֍         ֍      ֍         ֍
֍         ֍      ֍         ֍      ֍         ֍          ֍         ֍      ֍         ֍      ֍         ֍
֍         ֍֍֍֍֍֍֍֍         ֍֍֍֍֍֍֍֍                              ֍֍֍֍֍֍֍֍         ֍֍֍֍֍֍֍֍         ֍
֍      +                                                                      +                    ֍
֍                                                                                       +          ֍
֍                           +                                                                      ֍
֍                     ֍                                                      ֍                     ֍
֍                     ֍                       ֍       ֍                       ֍                    ֍
֍      ֍              ֍              ֍         ֍     ֍         ֍               ֍+           ֍      ֍
֍       ֍       +     ֍             ֍           ֍   ֍           ֍      +        ֍          ֍       ֍
֍        ֍            ֍            ֍           ֍     ֍           ֍              ֍         ֍        ֍
֍         ֍           ֍ +         ֍           ֍       ֍           ֍             ֍        ֍         ֍
֍                     ֍                                                        ֍                   ֍
֍                     ֍                                        +              ֍                    ֍
֍            +        ֍                                                      ֍         +           ֍
֍                              +                                                                   ֍
֍                                                                                                  ֍
֍         ֍                       ֍                              ֍                       ֍         ֍
֍          ֍                     ֍                ֍               ֍                     ֍          ֍
֍           ֍֍֍֍֍֍֍֍֍֍֍֍֍֍֍֍֍֍֍֍֍                ֍ ֍               ֍֍֍֍֍֍֍֍֍֍֍֍֍֍֍֍֍֍֍֍֍  +        ֍
֍            ֍                                  ֍   ֍                                 ֍            ֍
֍             ֍ +             ֍                ֍     ֍               ֍             + ֍             ֍
֍        +     ֍֍֍֍֍֍֍֍֍֍֍֍֍֍֍                ֍       ֍               ֍֍֍֍֍֍֍֍֍֍֍֍֍֍֍              ֍
֍                                            ֍         ֍                                           ֍
֍                                           ֍           ֍                                          ֍
֍֍֍֍֍֍֍֍֍֍֍֍֍֍֍֍֍֍֍֍֍֍֍֍֍֍֍֍֍֍֍֍֍֍֍֍֍֍֍֍֍֍֍֍֍֍֍֍֍֍֍֍֍֍֍֍֍֍֍֍֍֍֍֍֍֍֍֍֍֍֍֍֍֍֍֍֍֍֍֍֍֍֍֍֍֍֍֍֍֍֍֍֍֍֍֍֍֍֍֍